11111111111111111111111
10000000000X00000000001
100000000000000000X0001
1000X000000000000000001
100000000000000000000X1
1X000000000000000000001
10000000000P00000000001
1000000000000000X000001
100000X0000000000000001
1000000000000000000X001
100X00000C00000000000E1
11111111111111111111111