111111111111111111111111111111
10P0000000C0000000000000000001
100000000000000000000000000001
10000000000000000000000C000001
100000000000000000000000000001
100000000000000000000000000001
100000000000000000000000000001
1000000000000C0000000000000001
100000000000000000000000000001
100000000000000000000000000001
100000000000000000000000000001
100000000000000000000000000001
100000000000000000000000000001
1000000C0000000000000000000001
100000000000000000000000000E01
111111111111111111111111111111